################
#J.............#
#.####.####.#.#
#.#O...#....#.#
#.#.####.####.#
#.O..........O#
#.###.####.##.#
#............C#
################